####################
#..................#
#......*...........#
#..................#
#LLLLLLLLLLLLLLLLLL#
#..................#
#.........///////..#
#...........*......#
#........***.......#
#........LLL.......#
#........LLL.......#
#........LLL.......#
#......LLLLLLLLL...#
#..................#
#..................#
#....L.............#
#..................#
#..................#
#..................#
####################